[
	{
		"name": "level-0",
		"level": [
			["0","0","0","0","0","0","0","0","0","0","0","0","0","0","0"],
			["0","0","0","0","0","0","0","0","0","0","0","0","0","0","0"],
			["0","0","0","0","0","0","0","4","2","5","0","0","0","0","0"],
			["0","0","2","2","2","0","0","0","0","0","0","0","0","0","0"],
			["2","2","1","1","1","2","2","0","0","0","2","2","2","2","2"]
		]
	},
	{
		"name": "level-1",
		"level": [
			["o","o","o","o","o","o","o","o","o","o","o","o","o","o","o","o","o","o"],
			["o","o","o","o","o","o","o","o","o","o","o","o","o","o","o","o","o","o"],
			["o","0","0","0","0","0","0","0","0","0","0","0","0","0","0","0","0","o"],
			["o","0","0","0","0","0","0","0","0","0","0","0","0","0","0","0","0","o"],
			["o","0","0","0","0","0","0","0","0","0","0","0","0","0","0","0","0","o"],
			["o","0","0","0","0","0","0","0","0","0","0","0","0","0","0","0","0","o"],
			["o","0","0","0","0","0","0","0","0","0","0","0","0","0","0","0","0","o"],
			["o","0","0","0","0","0","0","0","4","2","2","5","0","0","0","0","0","o"],
			["o","0","0","2","2","2","0","0","0","0","0","0","0","0","0","0","0","o"],
			["o","2","2","1","1","1","2","2","0","0","0","0","2","2","2","2","2","o"],
			["o","o","o","o","o","o","o","o","o","o","o","o","o","o","o","o","o","o"]
		]
	}
]